6666666666666666666666666666666666666666
6666666666666666666666666666666666666666
66I2222266666622222222226666622222222666
6666662266666622666666226666622666662666
6666662266666622666666226666622666662666
6666662222222222666666222222222666662666
6666666666666666666666666666666666662666
6622222222222222222266666622222222222666
6622666666666666662266666622666666666666
6622666666666666662266666622666666666666
6622222222222222222266666622222222222266
6666666666666666666666666666666666662266
6622222222222222222222222222222222222266
6622666666666666666666666666666666666666
6622666666666666666666666666666666666666
6622222222222222222222222222222222222266
6666666666666666666666666666666666662266
6666222222222222222222222222222222222266
6666226666666666666666666666666666666666
6666226666666666666666666666666666666666
6666222222222222222222222222222222222225
6666666666666666666666666666666666666665
6666666666666666666666666666666666666666
