3333333333333333333333333333333333333333
3222222222222222222222222222222222222223
3211111111111111111111111111111111111123
3212111222222222222222222222222222111123
3211111211111111111111111111111111111123
3211111211111111111111111111111111111123
3211111211111111111111111111111111111123
3222222111111111111111111111111112222223
3111111211111111111111111111111111111113
3111111211111111111111111111111111111113
3111111211111111111111111111111111111113
3111111211111111111111111111111111111113
3222222221111111111111111111111112222225
3111111111111111111111111111111111111113
3333333333333333333333333333333333333333
