WWWWWWWWWWWWWWWWWWWWWWWWWWWWWWWWWWWWWWWW
WSSSSSSSSSSSSSSSSSSSSSSSSSSSSSSSSSSSSSW
WSTTTTTTTTTTTTTTTTTTTTTTTTTTTTTTTTTTTSW
WSTBBBSSSSSSSSSSSSSSSSSSSSSSSSSSSSBBTSW
WSTBGBSGGGGGGGGGGGGGGGGGGGGGGGGGGSBBTSW
WSTBBBSGGGGGGGGGGGGGGGGGEGGGGGGGGSBBTSW
WSTTTTSGGGGEGGGGGGGGGGGGGGGGGGGGSBBTSW
WSSSSSSGGGGGGGGGGGGGGGGGGGGGGGGGSSSSSW
WTTTTTSGGGGGGGGGGGGGGGGGGGGGGGGGTTTTTW
WBBBBBSGGGGGGGGGGGGGEGGGGGGGGGGGBBBBBW
WBBBBBSGGGGGGGGGGGGGGGGGGGGGGGGGBBBBBW
WTTTTTSGGGGGGGGGGGGGGGGGGGGGGGGGTTTTTW
WSSSSSSSGGGGGGGGGGGGGGGGGGGGGGGGSSSSSP
WGGGGGGGGGGGGGGGGGGGGGGGGGGGGGGGGGGGGW
WWWWWWWWWWWWWWWWWWWWWWWWWWWWWWWWWWWWWW
