TTTTTTTTTTTTTTTTTTTTTTTTTTTTTTTTTTTTTTTT
TGGGGGGGGGGGGGGTGGGGGGGGGGGGGGGGGGGGGGGT
TSSSSSSSSSSSSSSSSSSSSSSSSSSSSSSGGGGGGGGT
TGGGGGGGGGGGGGGTGGGGGGGGGGGGGGSGGGGGGGGT
TGGGGGGGGGGGGGGTGGGGSSSSSSSSGGSGGGGGGGGT
TGGGGGGGGGGGGGGTGGGGSGGGGGGSGGSSSSSGGGGT
TGGGGGGGGGGGGGGTGGGGSGGGGSGSGGGGGGSGGGGT
TSSSSSSSSSSSSSSSSSSSSGGGGSGSGGGGGGSGGGGT
TGGGGGGGGGGGGGGGGGGGGGGGGEGSGGGGGGSGGGGT
TGGGGTTTTTTTTTTTTTTTTTTTTETSSSSSSSSTGGGT
TGGGGGGGGGGGGGGGGGGGGGGGGEGGGGGGGGSSSSGT
TSSSSSSSSSSSSSSSSSSSSSSSSSGGGGGGGGGGGSGT
TGGGGGGGGGGGGGGGGGGGGGGGGGGGGGGGGGGGGSPT
TGGGGGGGGGGGGGGGGGGGGGGGGGGGGGGGGGGGGGGT
TTTTTTTTTTTTTTTTTTTTTTTTTTTTTTTTTTTTTTTT
