1111111111111111111111111111111111111111
1111111111111111000000000000000001111111
1111111111111111011111111111111011111111
1111111111110000000000000000000111111111
1111111111110111101111111111011111111111
1111111111110111101111111111011100000000
1111111111110111101111111111011111111110
0000000000000000111111111111011111111102
1111101111111111111111111111011111110111
1111101111111111111111111111011100000111
1111101111111111111111111100000000000111
1111101111111111111111111111111011111111
1111100000000000000000000000000111111111
1111111111111111111111111111111111111111
1111111111111111111111111111111111111111