1111111111111111111111111111111111111111
1110001001000002222222222222222001000011
1100100010000002011100110001002010010011
1001001100222222222222222211102001001011
1010010100211102101001010211102100100111
1100101000211102010100101211102222222222
1001010010211102100010010211110110100112
I222222222555555010101001211010101022221
1100121010100101010010100211001010121555
1010121001010010101001010211112222221555
1001121100101001010100100222222222221555
1100121010010100101010100100112010101555
1010122222222222222222222222222001010555
1001011010101010010101010101010100101555
1100100101010101001010101010101010010555